1
5 5
1 3
主城
0 2 1 2 0
0 1 1 1 0
0 1 3 1 0
0 1 1 1 0
0 0 0 0 0