2
5 5
1 3
野外
4 6 5 7 4
4 5 5 5 4
4 5 8 5 4
4 5 5 5 4
4 4 4 4 4